WWWWWWWWWWWWWWWWWWWWWWWWWWWWWWWWWWWWWWWWWWWWWWWWWWWWW
WTTTTTTTTTTTTTTTTTTTTTTTTTTTTTTTTTTTTTTTTTTTTTTTTTTTW
WTTTTTTTTTTTTTTTTTTTTTTTTTTTTTTTTTTTTTTTTTTTTTTTTTTTW
WTTTTTTTTTTTTTTTTTTTTTTTTTTTTTTTTTTTTTTTTTTTTTTTTTTTW
WTTT               TT           TT               TTTW
WTTT BBBBBBBBBBBBB TT           TT BBBBBBBBBBBBB TTTW
WTTT BBBBBBBBBBBBB TT    AAA    TT BBBBBBBBBBBBB TTTW
WTTT BBBBBBBBBBBBB TT   AAAAA   TT BBBBBBBBBBBBB TTTW
WTTT BBBBBBBBBBBBB TT  AAAAAAA  TT BBBBBBBBBBBBB TTTW
WTTT BBBBDDBBBBBBB TT  AAAAAAA  TT BBBBBBBBBBBBB TTTW
D                  TT  AAAAAAA  TT BBBBBBBDDBBBB TTTW
D                  TT   AAAAA   TT                  D
WTTT               TT    AAA    TT                  D
WTTT               TT           TT               TTTW
WTTTBBBBB                                        TTTW
WTTTBBBBB                                        TTTW
WTTTBBBDB        TTTTTTTTTTTTTTTTTTT             TTTW
WTTTBB        BBBTTTTTTTTTTTTTTTTTTTBDBBB    BBBBTTTW
WTTTBB        BBBTTBBBBBBBBBBBBBBBTTBBBBB    BBBBTTTW
WTTTBB AA     BBBTTBBBBBBBBBBBBBBBTTBBBBD    BBBBTTTW
WTTTBB AA     BBBTTBBTTTTTTTTTTTBBTTBBBBB    BBBBTTTW
WTTTBB        DBBTTBBTTTTTTTTTTTBBTTBBBBB    DBBBTTTW
WTTTBB        BBBTTBBTTBBTTTBBTTBBTTBBBBB    BBBBTTTW
WTTTBBBDB        TTBBTTBBBBBBBTTBBTTBBBBB    BBBBTTTW
WTTTBBBBB        TTBBTTTBBBBBTTTBBTTBBBBD    BBBBTTTW
WTTTBBBBB     BBBTTBBTTTBBBBBTTTBBTTBBBBB        TTTW
WTTT          DBBTTBBTTTBBBBBTTTBBTTBBBBB        TTTW
WTTT          BBBTTBBTTBBBBBBBTTBBTTBBB     BBDBBTTTW
WTTTBBBBB     BBBTTBBTTBB   BBTTBBTTBBB     BBBBBTTTW
WTTTBBBBB     BBBTTBBTTTT   TTTTBBTTBBB     BBBBBTTTW
WTTTBBBBD     BBBTTBBTTTT   TTTTBBTTBBB     BBBBBTTTW
WTTTBBBBB     BBBTTBBBBBB   BBBBBBTT        BBBBBTTTW
WTTTBBBBB        TTBBBBBB   BBBBBBTTBBBB    BBBBBTTTW
WTTTBBB          TTTTTTTT   TTTTTTTTBBBB    BBBBBTTTW
WTTTBBB          TTTTTTTT   TTTTTTTTBBBB    DBBBBTTTW
WTTTBBB          TTTTTTTT   TTTTTTTT        BBBBBTTTW
WTTTBBD          TTTTT         TTTTTBBBB         TTTW
WTTTBBB          TTTTT CCCCCCC TTTTTBBBB     BBBBTTTW
WTTTBBB          TTTTT C     C TTTTTBBBB     BBBBTTTW
WTTT                   C AAA C               BBBBTTTW
WTTT                   C AAA C                   TTTW
WTTT  BBDBBBDBB  T  TT C AAA C TTTTTBBBB     BBBBTTTW
WTTT  BBBBBBBBB  T  TT C     C TTTTTBBBB     BBBBTTTW
WTTT  BBBBBBBBB  T  TT CCCCCCCCCCTTTBBBB  A  BBBBTTTW
WTTT  BBBBBBBBB  T  TT         CCTTT     AAA     TTTW
WTTT  BBBBBBBBB  T  TTTTTTTTTTTCCTTTBBBB  A  BBBBTTTW
WTTT  BBBBBBBBB  T  TTTTTTTTTTTCCTTTBBBB     BBBBTTTW
WTTT  BBBBBBBBB  T  TTTTTTTTTTTCCTTTBBBB     BBBBTTTW
WTTTTTTTTTTTTTTTTT  TTTTTTTTTTTCCTTTTTTTTTTTTTTTTTTTW
WTTTTTTTTTTTTTTTTT  TTTTTTTTTTTCCTTTTTTTTTTTTTTTTTTTW
WTTTTTTTTTTTTTTTTT  TTTTTTTTTTTCCTTTTTTTTTTTTTTTTTTTW
WWWWWWWWWWWWWWWWWWDDWWWWWWWWWWWDDWWWWWWWWWWWWWWWWWWWW