WWWWWWWWWWWWWWWWWWWWWWWWWWWWWWWWWWWWWWWWWWWWWWWWWWWWW
WTTTTTTTTTTTTTTTTTTTTTTTTTTTTTTTTTTTTTTTTTTTTTTTTTTTW
WTTTTTTTTTTTTTTTTTTTTTTTTTTTTTTTTTTTTTTTTTTTTTTTTTTTW
WTTTTTTTTTTTTTTTTTTTTTTTTTTTTTTTTTTTTTTTTTTTTTTTTTTTW
WTTT               TT           TT               TTTW
WTTT BBBBBBBBBBBBB TT           TT BBBBBBBBBBBBB TTTW
WTTT BBBBBBBBBBBBB TT    AAA    TT BBBBBBBBBBBBB TTTW
WTTT BBBBBBBBBBBBB TT   AAAAA   TT BBBBBBBBBBBBB TTTW
WTTT BBBBBBBBBBBBB TT  AAAAAAA  TT BBBBBBBBBBBBB TTTW
WTTT BBBBDDBBBBBBB TT  AAAAAAA  TT BBBBBBBBBBBBB TTTW
D                  TT  AAAAAAA  TT BBBBBBBDDBBBB TTTW
D                  TT   AAAAA   TT                  D
WTTT               TT    AAA    TT                  D
WTTT               TT           TT               TTTW
WTTTBBBBB                                        TTTW
WTTTBBBBB                                        TTTW
WTTTBBBDB        TTTTTTTTTTTTTTTTTTT             TTTW
WTTTBB        BBBTTTTTTTTTTTTTTTTTTTBDBBB    BBBBTTTW
WTTTBB        BBBTTBBBBBBBBBBBBBBBTTBBBBB    BBBBTTTW
WTTTBB AA     BBBTTBBBBBBBBBBBBBBBTTBBBBD    BBBBTTTW
WTTTBB AA     BBBTTBBTTTTTTTTTTTBBTTBBBBB    BBBBTTTW
WTTTBB        DBBTTBBTTTTTTTTTTTBBTTBBBBB    DBBBTTTW
WTTTBB        BBBTTBBTTBBTTTBBTTBBTTBBBBB    BBBBTTTW
WTTTBBBDB        TTBBTTBBBBBBBTTBBTTBBBBB    BBBBTTTW
WTTTBBBBB        TTBBTTTBBBBBTTTBBTTBBBBD    BBBBTTTW
WTTTBBBBB     BBBTTBBTTTBBBBBTTTBBTTBBBBB        TTTW
WTTT          DBBTTBBTTTBBBBBTTTBBTTBBBBB        TTTW
WTTT          BBBTTBBTTBBBBBBBTTBBTTBBB     BBDBBTTTW
WTTTBBBBB     BBBTTBBTTBB   BBTTBBTTBBB     BBBBBTTTW
WTTTBBBBB     BBBTTBBTTTT   TTTTBBTTBBB     BBBBBTTTW
WTTTBBBBD     BBBTTBBTTTT   TTTTBBTTBBB     BBBBBTTTW
WTTTBBBBB     BBBTTBBBBBB   BBBBBBTT        BBBBBTTTW
WTTTBBBBB        TTBBBBBB   BBBBBBTTBBBB    BBBBBTTTW
WTTTBBB          TTTTTTTT   TTTTTTTTBBBB    BBBBBTTTW
WTTTBBB          TTTTTTTT   TTTTTTTTBBBB    DBBBBTTTW
WTTTBBB          TTTTTTTT   TTTTTTTT        BBBBBTTTW
WTTTBBD          TTTTT         TTTTTBBBB         TTTW
WTTTBBB          TTTTT         TTTTTBBBB     BBBBTTTW
WTTTBBB          TTTTT         TTTTTBBBB     BBBBTTTW
WTTT                     AAA                 BBBBTTTW
WTTT                     AAA                     TTTW
WTTT  BBDBBBDBB  T  TT   AAA   TTTTTBBBB     BBBBTTTW
WTTT  BBBBBBBBB  T  TT         TTTTTBBBB     BBBBTTTW
WTTT  BBBBBBBBB  T  TT           TTTBBBB  A  BBBBTTTW
WTTT  BBBBBBBBB  T  TT           TTT     AAA     TTTW
WTTT  BBBBBBBBB  T  TTTTTTTTTTT  TTTBBBB  A  BBBBTTTW
WTTT  BBBBBBBBB  T  TTTTTTTTTTT  TTTBBBB     BBBBTTTW
WTTT  BBBBBBBBB  T  TTTTTTTTTTT  TTTBBBB     BBBBTTTW
WTTTTTTTTTTTTTTTTT  TTTTTTTTTTT  TTTTTTTTTTTTTTTTTTTW
WTTTTTTTTTTTTTTTTT  TTTTTTTTTTT  TTTTTTTTTTTTTTTTTTTW
WTTTTTTTTTTTTTTTTT  TTTTTTTTTTT  TTTTTTTTTTTTTTTTTTTW
WWWWWWWWWWWWWWWWWWDDWWWWWWWWWWWDDWWWWWWWWWWWWWWWWWWWW