WWWWWWWWWWWWWWWWWWWWWWWWWTTTTTTTTTTTTTTTTTTTTTTTTTTT
WWWWWWWDWWWWWWWWWWWWWWWWWWTTTTTTTTTTTTTTTTT TTTTTTTT
TT     P           HTTTTTTTTTTTTTTTTTTTTTTT TTTTTTTT
TT     P             TTTTTTTTTTTTTTTTTTTTTT TTTTTTTT
TT     P              TTTTTTTTTTTTTTTTTTTTT TTTTTTTT
TT     P               TTTTTTTTTTTTTTTTTTTT TTTTTTTT
TT  R  P                TTTTTTTTTTTTTTTTTTT TTTTTTTT
TT     P                  TTTTTTTTTTTTTTTTT TTTTTTTT
TT   R P     R       O      TTTTTTTTTTTTTTT TTTTTTTT
TT     PR    RO                TTTTTTTTTTTT TTTTTTTT
TT     P                          TTTTTTTTT TTTTTTTT
TT     P                            H            TTT
TT     P            H                             TT
TT     P                                          TT
TT     PP                    AA     H             TT
TT      PP                AAAAAAAA           O    TT
TT  RO   PP   R          AAAAAAAAAAAAAA           TT
TT        P  R          AAAAAAAAAAAAAAAA          TT
TT        P            AAAAAAAAAAAAAAAAAA         TT
TT        P        H  AAAAAAAAAAAAAAAAAAAA       RTT
TT        P          AAAAAAAAAAAAAAAAAAAAAA       TT
TT        P          AAAAAAAAAAAAAAAAAAAAAA       TT
TT        P         AAAAAAAAAAAAAAAAAAAAA         TT
TT        P       AAAAAAAAAAAAAAAAAAAAAA          TT
TT        P     AAAAAAAAAAAAAAAAAAAAAAAA          TT
TT        P  AAAAAAAAAAAAAAAAAAAAAAAAAA           TT
TT        P  AAAAAAAAAAAAAAAAAAAAAAAAA            TT
TT        P    AAAAAAAAAAAAAAAAAAAAA              TT
TT        P      AAAAAAAAAAAAAAAAAA               TT
TT        P       AAAAAAAAAAAAAAAA            S   TT
TT        P        AAAAAAAAAAAAAA      PPPPPPPPPPPPP
TT        P          AAAAAAAAA        PP          TT
TT       PPP                         PP           TT
TT       PSPP                       PP            TT
TT       P  PP                     PP             TT
TT       P   PPPPPPPPPPPPPPPPPPPPPPP              TT
TT       P                                        TT
TT       P                                        TT
TT       P                                        TT
TT       P                                        TT
TT       P                                        TT
TT       P                                        TT
TT       P                                        TT
TT       P                                        TT
TT       P                                        TT
TT       P                                        TT
TT       P                                        TT
TT       P                                        TT
TT       P                                        TT
TT       P                                        TT
TTTTTTTTTPTTTTTTTTTTTTTTTTTTTTTTTTTTTTTTTTTTTTTTTTTT
TTTTTTTTTPTTTTTTTTTTTTTTTTTTTTTTTTTTTTTTTTTTTTTTTTTT